11111111111111111111111111111111111111111111111111111111
10000000000000000000000000000000010100010100000000000001
100E0000000000000000000000000000010101010101111111111101
10000000000000CCC000000CCCCCCCC0010101010101000000000001
100000000000CCC000000CCC0000CCC0010001010101111111111101
1000000000CCC0CCC000000000CCC000011111010101000000000001
10000000CCC00CCC0000000CCC000000010000000001011111111101
100000CCCCCCCCCCC000CCC000000000010111010101000000000101
10000000000CCC0000CCC00000000000010101010101111111110101
1000000000CCC000CCCCCCCC00000000010101010100000000010101
10000000000000000000000000000000010101010111111111110101
10000000000000000000000000000000010000010000000000000101
10000100111101100001001111011000010111111111111111111101
1000000000000000C000000000000000000100P00C00000000000001
11111111111111111111111111111111111111111111111111111111
