1111111111111111111111111111111111111111111111111111111111
1000000000000000000000000000000000010100010100000000000001
100E000000000000000000000000000000010101010101111111111101
10000000000000CCC000000CCCCCCCC000010101010101000000000001
100000000000CCC000000CCC0000CCC000010001010101111111111101
1000000000CCC0CCC000000000CCC00000011111010101000000000001
10000000CCC00CCC0000000CCC00000000010000000001011111111101
100000CCCCCCCCCCC000CCC00000000000010111010101000000000101
10000000000CCC0000CCC0000000000000010101010101111111110101
1000000000CCC000CCCCCCCC0000000000010101010100000000010101
1000000000000000000000000000000000010101010111111111110101
1000000000000000000000000000000000010000010000000000000101
1111101111111110001111111111111011110111111111111111111101
1000000000000000C00000000000000000000100P00C00000000000001
1111111111111111111111111111111111111111111111111111111111
