11111111111111111111111111
10000000000000000000000001
100000000C000000C000000001
10000000000000000000000001
100100000C00000000000000C1
10000000000000000000000001
10000000000000000000000001
10000000000000000000000001
10000000000000000000000001
10000111110000000000000001
1P0011E0000000000000000001
11111111111111111111111111
