111111111111111111111111111111111111111111111111111111111111
10000000000000000000C000000000000000000000000000000000000001
10000000000000000000000000000000000000C000000000000000000001
100000000000000001111111111000001111111111000000000000000001
100000000000000000000000000000000000000000000000000000000001
1000000000000000000000000000P0000000000000000000000000000001
100000E00000000000000000000000000000000000000000000000000001
100000000000000000000000000000000000000000000000000000000001
100000000000000001111111111000001111111111000000000000000001
100000000000000000000000000000000000000000000000000000000001
100000000000000000000C0000000000000000C000000000000000000001
100000000000000000000000000000000000000000000000000000000001
100000000000000000000000000000000000000000000000000000000001
100000000000000000000000000000000000000000000000000000000001
100000000000000000000000000000000000000000000000000000000001
100000000000000000000000000000000000000000000000000000000001
100000000000000000000000000000000000000000000000000000000001
100000000000000000000000000000000000000000000000000000000001
100000000000000000000000000000000000000000000000000000000001
100000000000000000000000000000000000000000000000000000000001
100000000000000000000000000000000000000000000000000000000001
100000000000000000000000000000000000000000000000000000000001
100000000000000000000000000000000000000000000000000000000001
100000000000000000000000000000000000000000000000000000000001
100000000000000000000000000000000000000000000000000000000001
100000000001000000000010000000001000000000100000000010000001
100000000001000000000010000000001000000000100000000010000001
10000CC000010000CC000010000CC0001000CCC00010CCCC00001CCCCCC1
100000000001000000000010000000001000000000100000000CCCCCCCC1
100000000001000000000010000000001000000000100000000C1CCCCCC1
111111111111111111111111111111111111111111111111111111111111
