11111111111111111111111111111111111111111111111111111111111
10000C000000000000000000C0000100000000000000000000000000001
10000000111000001111100000000000000000000000000000000000001
10000001001000010000100000000100000000000000000000000000001
10000010001000C000011000C0000100000000000000000000000111111
100C1111111110000110000000001100000000000000001111111100001
10000000011000001000C00000010011111111111100001000000100101
1000000001100001111111100010C0P000000000010000100C01C1001C1
100000C0000000000000000000010011111111000100001000010100101
1000000000000000000000C00000110001000000010000100C01C1001C1
1000000000000C000000000000000000010011111100001000010100111
1000000000000000000000000000000100001000000000100C010100001
1000000000000000000001111000011100001000000000000001E100001
10000000000000000000000000000111000010000000001000000100001
11111111111111111111111111111111111111111111111111111111111
